PPPPPPPPPPPPPPPPPPPPPPPPPPPPPPPPPPPPPPPPPPPPPPPPPPPPPPPPPPPPPPPPPPPPPPPPPPPPPPPPPP
P                                                                                P
P                                                                                P
P                                                                                P
P                                                                                P
P                                                                                P
P                                                                                P
P                                                                                P
P                                                                                P
P                                                                                P
P                                                                                P
P                                                                                P
P                                                                                P
P                                                                                P
P                                                                                P
P                                                                                P
P                                                                                P
P                                                                                P
P                                                                                P
P                                                                                P
P                                                                                P
P                                                                                P
P                                                                                P
P                                                                                P
P                                                                                P
P                                                                                P
P                                                                                P
P                                                                                P
P     PPPPPPPPPPPPPPPPPPPPPPPPPPPPPPPPPPPPPPPPPPPPPPPPPPPPPPPPPPPPPPPPPPPPP      P
P     PBBBBBBBBBBBBBBBBBBBBBBBBBBBBBBBBBBBBBBBBBBBBBBBBBBBBBBBBBBBBBBBBBBBP      P
P     PP                                                                 PP      P
P     PPP                     PPPPPP          PPPPPP                    PPP      P
P      PPP                PPPPPPPPPPPP      PPPPPPPPPPP                PPP       P
P       PPP            PPPPPPPPPPPPPPPPP  PPPPPPPPPPPPPPPP            PPP        P
P        PPP        PPPPPPPPPPPPPPPPPPPPLRPPPPPPPPPPPPPPPPPPP        PPP         P
P         PPP      PPPPPPPPPPPPPPPPPPPPPPPPPPPPPPPPPPPPPPPPPPP      PPP          P
P          PPP      PPPPPPPPPPPPPPPPPPPPPPPPPPPPPPPPPPPPPPPPP      PPP           P
P           PPP       PPPPPPPPPPPPPPPPPPPPPPPPPPPPPPPPPPPPP       PPP            P
P             PPP        PPPPPPPPPPPPPPPPPPPPPPPPPPPPPPP        PPP              P
P               PPP         PPPPPPPPPPPPPPPPPPPPPPPPP         PPP                P
P                 PPP          PPPPPPPPPPPPPPPPPPP          PPP                  P
P                   PPP           PPPPPPPPPPPPP           PPP                    P
P                    PPPP   X         PPPPP         Y   PPPP                     P
PPPPPPPPPPPPPPPPPPPPPPPPPPPPPPPPPPPPPPPPPPPPPPPPPPPPPPPPPPPPPPPPPPPPPPPPPPPPPPPPPP