PPPPPPPPPPPPPPPPPPPPP
P        PP         P
PX      PPPP       YP
PPPPPPEPPPPPPPEPPPPPP
P     EP  P  PE     P
PEPPPPPP  P  PPPPPPEP
PE        P        EP
PPPPPEPPPPPPPPEPPPPPP
P    E  PPPP  E    PP
P  PPPP      PPPP   P
P        LR         P
PPPPPPPPPPPPPPPPPPPPP