PPPPPPPPPPPPPPPPPPPPP
P        PP         P
PX     PPPPPPP     YP
PPPPPPEPPPPPPPEPPPPPP
P     EP     PE     P
PEPPPPPP     PPPPPPEP
PE    PPPPPPPP     EP
PPPPPEPPPPPPPPEPPPPPP
P    E  PPPP  E    PP
P  PPPP      PPPP   P
P        LR         P
PPPPPPPPPPPPPPPPPPPPP